XXXXXXXX
XLX    X
X X    X
X X P  X
X X  C X
X    X X
X   C  X
XXXXXXXX
